Titre : "Facile"
W.T..W.....
W.B..W.....
W....W.....
W....W.....
W..........
W....W.S...
W....W.....
W....W.....
W....W....W
